0001001010
0100000001
0011000000
0100001000
0000000010