0001001010
0100000001
0011001111
0100001000
0000000010